25 27
6 7 7 7 7 16 16 16 16 16 1 1 1 1 1 1 1 1 1 1 1 1 1 1 1 1 16
6 16 16 16 16 16 16 16 16 16 1 1 1 1 1 1 1 1 1 1 1 1 1 1 1 1 16
6 16 16 16 4 24 16 16 16 16 1 1 1 1 1 1 1 1 1 1 24 1 1 1 1 1 16
7 16 16 16 16 16 16 16 16 16 16 16 16 16 16 16 16 16 16 16 0 24 5 16 16 16 16
7 16 5 26 16 16 16 16 16 16 16 16 16 16 16 16 16 16 16 16 16 16 16 16 16 16 16
7 16 16 16 16 16 16 16 1 16 0 16 16 16 16 16 16 16 16 16 16 16 16 16 16 16 16
32 32 32 32 32 31 16 16 16 16 16 16 16 16 16 16 16 16 16 16 16 16 16 16 16 16 16
37 37 37 37 40 30 1 1 0 0 16 16 16 16 16 16 16 16 16 16 1 1 16 16 16 16 16
16 16 25 23 39 30 14 15 1 16 16 16 16 16 16 16 16 16 16 16 0 0 16 16 16 16 16
16 35 35 35 39 30 1 1 16 16 16 16 16 16 1 1 16 16 16 16 0 0 16 16 16 16 16
16 36 36 36 39 30 16 16 16 16 16 16 16 0 14 15 0 16 16 16 16 16 16 16 16 16 16
16 35 35 35 39 30 16 16 16 16 16 16 16 16 1 1 16 16 16 16 16 16 16 16 16 16 16
16 36 36 36 39 30 13 23 26 16 16 16 16 16 16 16 16 16 16 16 16 26 26 16 16 16 16
16 35 35 35 39 30 21 26 16 16 16 16 16 16 16 16 16 16 16 16 26 14 15 26 16 16 16
16 36 36 36 39 30 21 16 16 16 16 16 16 16 16 16 16 16 16 16 4 26 25 16 16 16 16
16 35 35 35 39 30 21 16 16 16 16 16 16 16 24 24 16 16 16 16 16 16 16 16 16 16 16
16 36 36 36 39 30 21 16 16 24 25 16 16 24 15 14 24 16 16 16 16 23 23 16 16 16 16
16 35 35 35 39 30 21 16 16 16 16 16 16 16 24 24 16 16 16 16 16 23 24 16 16 16 16
16 36 36 36 39 30 21 16 16 16 16 16 16 16 16 16 16 16 4 16 16 16 16 16 16 16 16
16 16 24 26 39 30 21 16 16 16 16 16 16 16 16 16 16 16 16 16 16 16 16 16 16 16 16
37 37 37 37 38 30 22 16 15 26 16 16 16 16 16 16 16 16 16 16 16 16 16 16 16 16 16
28 28 28 28 28 29 5 16 16 16 16 16 16 16 16 16 16 16 16 16 16 16 16 16 16 16 16
6 16 25 16 1 1 1 1 1 1 1 1 1 1 1 1 1 1 1 1 1 1 1 1 1 1 6
6 16 16 16 1 1 1 1 1 1 1 1 1 1 1 1 1 1 1 1 1 1 1 1 1 1 6
6 16 16 16 0 0 0 0 0 0 0 0 0 0 0 0 0 0 0 0 0 0 0 0 0 0 6